■■■■■?■?■■
????■?????
■???????■?
■???■■????
?????■????
?■?■■■■■■■
?■■■■?■■■■
